111111111111111111111111111111
1000001C0000000000000000000011
100011010110000000000000001001
1000000000000CM000010010100C01
10001C00110010000000C001001001
1011010110000000000000C0011001
110000111000000C00010001100011
10010C000100C10000100000000001
101000001000101000001101000101
1C0011110000C011000000010C0001
100010000000C010010110100000C1
10001110000001C010000100010001
101000000000000000000111001001
100100C10001110100000000010011
100000000010100001000100100001
1C1000000011000000001001100001
10101CM1111000100000C001111001
100100000010010001010000C01001
100000000100C1000000C0001000C1
10010010000C010100010M10100001
1011C0110C10CC0011000000101011
100110000100000000000000100011
1001M1000100000011111001100011
101100011010000111000010000001
100100010101100C00000000000011
100000100110100M00000011000101
10100000010011100101M000010101
100100001M01010000100011001001
1010101110010000001000C0C10001
110000100111100110000C00110001
1000C0100C00101010000001000101
1000000000C100C100101000001M01
10001C110000000000010100100101
1000001011001C0000011000000101
100M0110010M000000100010101101
1010M1110000110000000100000001
1E01000010100000000101000101C1
10010010101010001C0000C0000101
11000C000101C11000000P01000001
1001010000000000101001000C0101
100000100000110001100011110001
100001100010100110000010000001
1100011011000011C0011100000001
1010101001100000M00001C0000001
100000000000000100001100100001
1000C0000000000000001000000001
10000010110010100MC00000000001
100110C000101000C1010000101001
111111111111111111111111111111