111111111111111111
101000000000000011
100010001001011011
1010000000001C1101
1000C0000001000101
100001110010010001
100000010C10001011
1100000010M1100001
101000000M00000011
111000001001100011
1010C000C0000000C1
111001100010000001
100MM0000011010101
111E00001C00000011
101M11000C10100011
100110010011000101
101000101C00010001
101100001000110001
11010100001001C001
101011000CPMCM0001
1000000111M0M00111
111111111111111010