11111111111111111111111111111111111111111111111111
10011000100M00000000000000100010111C00101000000111
1100001001101000P11000000000C000C1000M001101010011
1001000100000C01000011C000000010000000001010100E11
110010000001010001000000100100000000100000C0000001
101011000C000000010000010110100010000010010C010101
11111111111111111111111111111111111111111111111111