111111111111111111111111111111
1000001C0000000000000000000011
10010C000100C10000100000000001
101000001000101000001101000101
1C0011110000C011000000010C0001
100010000000C010010110100000C1
10001110000001C010000100010001
101000000000000000000111001001
100100C10001110100000000010011
100000000010100001000100100001
1C1000000011000000001001100001
10101CM1111000100000C001111001
100100000010010001010000C01001
100000000100C1000000C0001000C1
1000000000C100C100101000001M01
10001C110000000000010100100101
1000001011001C0000011000000101
100M0110010M000000100010101101
1010M1110000110000000100000001
1E01000010100000000101000101C1
10010010101010001C0000C0000101
11000C000101C11000000P01000001
1001010000000000101001000C0101
100000100000110001100011110001
100001100010100110000010000001
111111111111111111111111111111