11111111111111111111111111111
111000C01010C0000000000000101
110101C001010010000000100C111
100000001100010001000100000M1
1011000110010M000000001000101
10000MC10C1110010010110000101
10110000000000000001010000001
10101000101110000001000000001
100000100001101010000000M0011
10001010000100010100010C00011
111C0010C0001001C000010001101
100C01P1011010000001000000011
1000000010C000100000001000011
10101100101010010000000011001
10001110C00000101000010001001
10000C000101101010000010000C1
1001100C1101101010100000C0001
10100100010100011000110000101
1000000110C0C00000C0000000001
10000000100000010000000110101
10010010000100000100010000001
10000100001100000010C00100001
1010100000100110100C100000001
11010111000001000000000010101
1010000011C000010000100000011
1001000000000100010000000C001
1001100CC10000001011000010101
10100C101000M1000000101010001
1000000C000100010000001110011
1C1101000M00100C0100C00000E11
1010000010100M1010010000M1101
11111111111111111111111111111