1111111111
1010C00001
1000110011
1001000101
1011001001
1000100001
1000100001
1011000C01
10E000C0C1
10000C0001
1100110001
110C010001
1110001001
1101001001
1001000001
1010010011
1100101001
1000000001
1001000001
1000010011
1000100011
1010000001
1110000001
1000100011
10100P0011
1000000101
1111111111