1111111111111111111111111111111111111111
1000010000000111010100000101000011000001
10001000000100000100000100C0100011100001
1C10C0100011110001010100C000000100000011
10110010110C000110E100100000110010100001
1CC00000000C0000100010000010000101100001
101000000C000000C00110001001000010000101
1000011100011011000000000110101001000111
1010001C0000000001011001001C110000101001
100010100000000000001000C000010000001101
111000000000010000000C110100000010001111
100000000000000000000000M010011101110001
110000C010100100011000010010101001001011
1000101000110000110101100100C000C110C001
1001001001110000011C011M1110110110011001
1100001C00111000001111100100001010101001
10C1100000C00001110010101000000100000001
11010001000100001111001010010100000000C1
1000000100000110110000100000C00000C01001
10000000000000000101000010C0001000110001
1000101000001000101000C00000010000000001
1100001000010001C1001110000C100010C00001
10001001C01C1100000001000000100C000000C1
10110000010000000000000010C0000101000101
10010P0000110000000000000000100101000001
10000C1010C00000000100001000101000010001
11000000C0001000000010000100010010100001
1000010000000001000000001100010010100001
1001111000000000000C01C00001010011010101
101000100000110000010000C10000001100C001
110C001010100111C1111000000000100C011011
100010C00101000010C000000001010010000001
1110001100100001100000100001000010C00111
1101001000100010010100001100101000100001
1000010100000000000000001C00000000010001
1000C10110000000010010000000000010100001
10000010000C00100000011000C0000010011001
10000001000000M00101000000000C01100C0001
1111111111111111111111111111111111111111